BB...........................................................................................BB
BB...........................................................................................BB
BBBBBBBBBBBBBBBBBBBBBBBB.....................................................BBBB............BB
BBBBBBBBBBB.....BBBBBBBBB....................................................B...............BB
BBR.BB......B.....BBBBBBB....................................................................BB
BBRRRRRR....B.....BBBBBB...............................................E.............B.......BB
BBR.RRER...BBBB...BBBBBB.............................................R.......................BB
BBR.BR.....BBBBBB..BBBBB.............................................R.......................BB
BBR.......BBBBBBBB.BBBB..........................................R..RR................E......BB
BBR.......BBBBBBBB..BBB........................................RRR...RRR.............BBB.....BB
BB...B.....BBBBBBBB.BBB.........................................RRRRRR.RR............BB......BB
BB...B.....BBBBBBB..BBBB........................................RR.RRR.RR....................BB
BB........BBBBBB...BBBBB..BB.......................................................B.B...W...BB
BB........BBBBB.......B...B........................................E.................B.......BB
BB.........BBBB.......BBB..............B........................................B............BB
BB......................E....................................P.............B......BB.........BB
BB.....B.......B........B....................W....................................B.B........BB
BB...........................................................................................BB
BB.....B................B....................................................................BB
BB.........BBB..........BBB........................................B...BB....................BB
BB.........BBB...B..........B.................R...............B....B....BB...................BB
BB.................................B..........R..........B....B......BBB.....................BB
BB..........................................RRR..........B...................................BB
BB.........................................RRRR.........BBBBBB..BB...........................BB
BB..........................................R.R...B.....BBBBBB.............BB................BB
BB......................................................BBBBB..............BB................BB
BB.......................R.RR....................B......BBBB.................................BB
BB......................RRRRRR...........................BBB.B.B...........BB................BB
BB......................R..RRR...............................BBB..BB....B...................BBB
BB....................WRR...............................B.B..BBBB.BB......B....B............BBB
BB...................................................BBBBB...BBB.......BBBB.....BB...........BB
BB.................................................B.BBBBBBB.BBB.......BBB...B.BB..........BBBB
BB........................B........................BBBBBBBBBBBBB......BBBBB..BBBBB.....BBBBBBBB
BBBBBBBBBBBBBBBBBBBBBBBBBBBBBBBBBBBBBBBBBBBBBBBBBBBBBBBBBBBBBBBBBBBBBBBBBBBBBBBBBBBBBBBBBBBBBBB
BBBBBBBBBBBBBBBBBBBBBBBBBBBBBBBBBBBBBBBBBBBBBBBBBBBBBBBBBBBBBBBBBBBBBBBBBBBBBBBBBBBBBBBBBBBBBBB
