BB...........................................................................................BB
BB...........................................................................................BB
BBBBBBBBB.......................................W.........RRRR.............B.......BBB.......BB
BBBBBBBBB.................................................RRRR.....................BBBB....B.BB
BBBBBBBBBB.BB.............................................RRR......E.................B..B.B..BB
BBBBBBBBBB............E...............................W...RR.................................BB
BBBBBBBBBBB.B.............................................RR..........................BB.....BB
BBBBBBBBBBBBB..BBBB.....BB..............................RRR..................................BB
BBBBBBBBBBBBBBBBBBBB...BBB..................................................................BBB
BBBBBBBBBBBBBBBBBBBBBBBBB....................................................................BB
BBBBBBBBBBBBBBBBBB....B.............................................................RR.......BB
BBBBBBBBBBBBBBBBBB.BB...........................................................B...RRR......BB
BBBBBBBBBBBBBBBRR..B.........BBBE...................................................RR.......BB
BBBBBBB..RBBBBBRR..B.......BBBBBB...............................................RRRRR......BBBB
BBBBBBB..R.BBBBRRB...B....BBBBB.B..................................................RR...B....BB
BBBBBBB..B.RBBBR.........BBBBBB..............................................P...........B.B.BB
BBBBBBB..RRRBBBRRR.......BBB.................................................................BB
BBBBB.....RRRBRRRBR......BB........................E........................................BBB
BBBBB.....RBRBR.BRR..........................................................................BB
BBBBB..BBBBBRR...............................................................................BB
BBBBB.BBB..RRRR................................B.......................................B.....BB
BBBBB.......BR...............................................................................BB
BBBBB................................W.......................................................BB
BB...........................................................................................BB
BB.........................................................................................BBBB
BB........................................................................RR.................BB
BB.................................................RRR...................RRR.................BB
BB..........BB.........RRR........................RRRR....................R..................BB
BB.......B.............R.RRRR....................RRRRR..........RR..R.....RRR................BB
BB.......BB.............RRRRRRR..................RR.R...........RR.ERRR...RR.................BB
BBBBBB.BBB..............RRR.......................RRR............R..RRR......................BB
BBBBBBBBBB................RR.......................R.............RR..RR.................BBBBBBB
BBBBBBBBBB...BB.............BBBB..............B...................RRRR.................BBBBBBBB
BBBBBBBBBBBBBBBBBBBBBBBBBBBBBBBBBBBBBBBBBBBBBBBBBBBBBBBBBBBBBBBBBBBBBBBBBBBBBBBBBBBBBBBBBBBBBBB
BBBBBBBBBBBBBBBBBBBBBBBBBBBBBBBBBBBBBBBBBBBBBBBBBBBBBBBBBBBBBBBBBBBBBBBBBBBBBBBBBBBBBBBBBBBBBBB
